Level 2
#####
#   #####
# @ #   #
#   #@# #
#       #
#      ##
#  Ao o#
########