Level 3
######
#  # # ####
#    ###  #
##        #
#   A@    #
### @  #  #
#  #     o#
# ## ##o# # 
#         #
#       ###
#########
