Level 1
#######
#   o #
#     ##
#    @ #
#      #
##     #
 # A ###
 #####